%%%%%%%%%%%%%%%%%%%%
%   %....%  %....% %
%   %.  .%  %.  .% %
%%%%%.  .%%%%   .%%%
%.....  ......  ...%
%.....        .....%
%%%%%.    P   .%%%%%
%   %.        .%   %
%   %..........%   %
%%%%%%%%%%%%%%%%%%%%
